BBBBBBBBBBBBBBBBBBBBBBBBBBBB
B            BB            B
B BBBB BBBBB BB BBBBB BBBB B
B BBBB BBBBB BB BBBBB BBBB B
B BBBB BBBBB BB BBBBB BBBB B
B                          B
B BBBB BB BBBBBBBB BB BBBB B
B BBBB BB BBBBBBBB BB BBBB B
B      BB    BB    BB      B
BBBBBB BBBBB BB BBBBB BBBBBB
BBBBBB BBBBB BB BBBBB BBBBBB
BBBBBB BB          BB BBBBBB
BBBBBB BB BBBBBBBB BB BBBBBB
BBBBBB BB BBBBBBBB BB BBBBBB
          BBBBBBBB          
BBBBBB BB BBBBBBBB BB BBBBBB
BBBBBB BB BBBBBBBB BB BBBBBB
BBBBBB BB          BB BBBBBB
BBBBBB BB BBBBBBBB BB BBBBBB
BBBBBB BB BBBBBBBB BB BBBBBB
B            BB            B
B BBBB BBBBB BB BBBBB BBBB B
B BBBB BBBBB BB BBBBB BBBB B
B   BB                BB   B
BBB BB BB BBBBBBBB BB BB BBB
BBB BB BB BBBBBBBB BB BB BBB
B      BB    BB    BB      B
B BBBBBBBBBB BB BBBBBBBBBB B
B BBBBBBBBBB BB BBBBBBBBBB B
B                          B
BBBBBBBBBBBBBBBBBBBBBBBBBBBB